8888881F9889981F
988981F9888981F8
88991F8899881F89
8981F8899881F889
991F8889881F8988
91F8898881F89998
1FFFFFFF1FFFFFFF
1F8888881F888888
EEEEEEEEEEEEEEEE
EEEEEEEEEEEEEEEE
EEEEEEEEEEEEEEEE
EEEEEEEEEEEEEEEE
EEEEEEEEEEEEEEEE
EEEEEEEEEEEEEEEE
EEEEEEEEEEEEEEEE
EEEEEEEEEEEEEEEE